111111111111111111111111111111
10C0011110010000C1111000100C11
111101110000010011100000001111
1000000000000000000000000000E1
101111111100010000000011111001
10P001011110000000001010111111
100011111111111100000000110001
100000000000000000000000000001
100000111110000011111100000101
111110000000111110000000001111
100000000000000000001110000001
100001111110000000111100111011
1111111C0000001100111111111111
10000011111111110000000C111111
111111111111111111111111111111